....................
....................
....................
....................
....................
....................
....................
....................
...www..............
...ggw..............
...wgw..............
...wgw..............
...ggg..............
...wgw..............
...sgw..............
.g.wgw..............
.g.wgw..............
.gs.gw..............
.....w..............
....................
